当初は、いぐさと|てんそう|の二人に付き合わされ、夏コミ新刊４冊製作のアシスタントをヘトヘトになるまで付き合わされた。	助詞-格助詞	とて
『レミニセンス』は、２０１３年５月３１日に|てぃぐる|から発売された１８禁恋愛アドベンチャーゲーム。	助詞-格助詞	にて
ジャワの伝統芸能としてルドゥルッや|クトプラッ|という喜劇がある。	助詞-格助詞	ッと
主演には紗倉まな、|星美?りか|らが出演。	助詞-接続助詞	から
また、|西武?園?ゆうえんち|や豊島園で提示すれば入場料が割引される。	助詞-接続助詞	ちや
長崎では|長崎?くんち|や精霊流しの季節になると、解説者としてテレビに出演する。	助詞-接続助詞	ちや
主要スタッフもほぼ同じだが、キャラクターデザインがたかみちから交代し|かどつかさ|になっている。	助詞-副助詞	しか
元々メインだった|りんたろう|とは後年まで軋轢があったが現在では和解している。	助詞-副助詞	たり
２０１２－１３シーズンには１試合のみＦリーグ準会員リーグを戦っており、|フウガ?すみだ|に２－１で勝利している。	助詞-副助詞	だに
同年７月１２日に|新党?きづな|と衆議院で統一会派を結成。	助詞-副助詞	なと
２００６年６月の|みなし?機|の撤去に応じ、その対象である本機もほぼ全てのホールから姿を消すことになった。	助詞-副助詞	のみ
つづいてスタジオで、司会の|みのもんた|が	助詞-副助詞	のみ
またこれに関して２００７年８月１９日放送の|みゅーじん|で語った。	助詞-副助詞	のみ
フリージャーナリストの|みわ?よしこ|は夫の姉。	助詞-副助詞	のみ
愛媛県内では噺家というよりもローカルタレントとして広く知られ、「愛媛の|みのもんた|」と呼ばれている。	助詞-副助詞	のみ
会津藩降伏後は、消息が判明した覚馬を頼り、八重と孫の|みね|と共に京都へ移り住んだ。	助詞-副助詞	のみ
妻は女優でタレントの|みひろ|。	助詞-副助詞	のみ
昔はイラストレーターの|みつみ?美里|の熱烈なファンである。	助詞-副助詞	のみ
同じく漫画家の|みかまる|の夫で、最近は「あおきけい＆みかまる」の名義で活動している。	助詞-副助詞	のみ
同じ福山のものまねで活動中の|みっちー|に対する嫉妬が強い。	助詞-副助詞	のみ
日本勢としては、２０１４年の伊藤美誠、平野美宇の|みうみま|コンビ以来２年ぶりの快挙となった。	助詞-副助詞	のみ
母の|みさえ|が出かけている間に妹のひまわりの面倒を見ることになったしんのすけ。	助詞-副助詞	のみ
２０１５年７月１９日に|ビッグパレット?ふくしま|で第１回を開催し、以降年１回開催。	助詞-副助詞	まで
その姿は小人であったり、白髪の老人であったり、|雪?だるま|であったりと様々な説がある。	助詞-副助詞	まで
続いて建造されたましう、|さろま|では需給の問題から旅客定員が削減されている。	助詞-副助詞	まで
東京だるまは、別名多摩だるまともいわれ、東京都西部で生産されている|だるま|である。	助詞-副助詞	まで
