１９３３年、大城のぼる、謝花凡太郎、新関青花、|芳賀?たかし|らを起用し、漫画作品の刊行を始める。	助詞-終助詞	かしら
１９７０年|川村?たかし|らと「幼年芸術」を発刊した。	助詞-終助詞	かしら
同時期には|細川?たかし|らがいた。	助詞-終助詞	かしら
２０１２年からはアトラクションクリエイター|いわたか|も監修活動に加わっている。	助詞-接続助詞	かも
２０１６年６月には|いわたか|も脱退。	助詞-接続助詞	かも
また|池乃?めだか|も「あの番組は海外でシルクハットをかぶりながら阿波踊りを踊るようなものだった。	助詞-接続助詞	かも
また、主人公ようこを担当した|かない?みか|も林原同様に本作が出世作となった。	助詞-接続助詞	かも
姉の|青木?ゆみか|もタレントをしている。	助詞-接続助詞	かも
小学校高学年から樹里咲穂、|和央?ようか|も在籍していた宝塚コドモアテネに通っていた。	助詞-接続助詞	かも
アルバムには、ショーン・レノンや|清水?ひろたか|らが参加している。	助詞-格助詞	から
元々、|青木?さやか|らと温泉こんにゃくアクロバットショーという５人組のユニットを組んでいた。	助詞-格助詞	から
同期には茅原悠紀、乙藤智史、坂元浩仁、|仁科?さやか|らがいる。	助詞-格助詞	から
一般的な映画脚本のフォーマットのように、|柱?書き|や台詞の前の人物名はない。	助詞-接続助詞	きや
高冷地であることから古くから農業だけでは自給が難しい地域であったため、|木?挽き|や木かやとりといった山仕事の副業が営まれていた。	助詞-接続助詞	きや
東京都の里親制度である養育家庭制度が扱われ、|もんじゃ?焼き|や住吉神社例祭などの下町の文化も取り上げられる。	助詞-接続助詞	きや
特に初夏の若アユが美味とされ、若アユの|塩?焼き|や天ぷらは珍重される。	助詞-接続助詞	きや
これは基部にある内歯の形状と|てこ?の?原理|によるものである。	助詞-副助詞	とて
女芸人も可愛がっており、ロリィタ族や|たかまつ?なな|らと食事を共にする機会も多い。	助詞-副助詞	なら
昔からある千枚通しと用途は同じだが、手動のものは構造に|てこ?の?原理|が応用されており、より少ない力で済むようになっている。	助詞-格助詞	にて
１年生では、入学直後に広島県福山市沼隈町の|みろく?の?里|へ宿泊研修で行くことになっている。	助詞-副助詞	のみ
２０１５年のゆるキャラグランプリは、事前のネット投票では愛媛県の|みきゃん|に７０００票の差を付けられ２位だった。	助詞-副助詞	のみ
その近くの|みくり?ヶ?池|は、血の池として、また、剱岳は針山地獄であるとされた。	助詞-副助詞	のみ
ねばり強く政府と交渉した結果、刑務所を現在の|みよし?市|に移転させ、１００メートル道路を完成させる。	助詞-副助詞	のみ
みよし運動公園野球場は、広島県三次市東酒屋町の|みよし?運動?公園|内にある野球場である。	助詞-副助詞	のみ
現在の|みよし?市|の一部に該当する。	助詞-副助詞	のみ
主な活動拠点は沼隈町の|みろく?の里|を中心とした福山市。	助詞-副助詞	のみ
出演者は、事務所の仲間や、テレビ朝日のバラエティー番組|『ぷっ』すま|での共演者、童謡歌手、新人バンドであった。	助詞-格助詞	まで
総合司会はタモリと|明石家?さんま|で、テーマは「夢家族」。	助詞-格助詞	まで
富士見市中央部の富士見川越バイパス沿いに位置し、富士見市役所や|ららぽーと?富士見|が隣接する。	助詞-接続助詞	やら
